1111111111111111111111111111111111111111
1P000000000000000000000000000000000000E1
1111011111111111111110111111111111101111
1000010000000000000010000000000000100001
1001010111011111111010111111111101100001
1001010001010000000010100000000101100001
1001011101010111111010111111100101100001
1000000101010000000010000000100100000011
1011100101011111111011111110100101111011
1000100000000000000000000000100100000011
1000111111111111111111111111100111111011
1000000000000000000000000000000000000011
1011110111111111111111111011111111101111
1000000100000000000000000000000000100001
1111011101111111111111111111111101100001
1000010000000000000000000000000100000001
1001010111111111111011111111110101111011
1001010000000C00000010000000000100000011
1001010111111111111110111111110111111011
1111111111111111111111111111111111111111