1111111111111111111111111111111111111111
1P000111111111111111111111111111111000E1
1111011111111111111111111111111111101111
1111011111111111111111111111111111101111
1111011111111111111111111111111111101111
1111011111111111111111111111111111101111
11110000000000000C0C00000000000000101111
1111111111111111111111111111111100101111
1111111111111111111111111111111100101111
1111111111111111111111111111111100101111
1000000000000000000000111111111100101111
1111111111111111111100111111111100101111
11111111111111111111111111111111C0101111
1111111111111111111111111111111100101111
1111111111111111111111111111111100101111
1111000000000000000000000000000000101111
1111011111111111111111111111111111101111
1111011111111111111111111111111111101111
1111000000000000000000000000000000001111
1111111111111111111111111111111111111111