11111
10000000001
10000000001
10000000001
11111