111111111111111111111
1P0000000000000000001
111111011110110110001
1000000011C01101C0001
1C1111111111111111111
1C1111111111111111111
1C1111111111111111111
1C1111111111111111111
10000000000C0000000E1
111111111111111111111