1111111111111111111111111111111111111111
1E00000000000000000000000000000000000001
1C10010100000000000000000000000000000101
1000010010100000000000000000000000000001
1C01010101101010000000001111110000110001
1P00111111111111111110010001111000000001
1000111111110000000000111111111000000001
1111111111111111111111111111111111111111
1111111111111111111111111111111111111111
1111111111111111111111111111111111111111
1111111111111111111111111111111111111111