1111111111
1E00000001
11111C1001
1000000001
10000000P1
1111111111