1111111111111111111111111111111111111111
1E00000000000000000000000000000000000001
1010010100000000000000000000000000000101
1000010010100000000000000000000000000001
1001010101101010000000001111110000110C01
1P0011111111111111111001000111100000C001
100011111111C000000000111111111000000001
1111111111111111111111111111111111111111
1111111111111111111111111111111111111111
1111111111111111111111111111111111111111
1111111111111111111111111111111111111111
1111111111111111111111111111111111111111
1111111111111111111111111111111111111111